Huoneen formaatti:
Aluksi Huoneen Layout numeroina
0 muuri, 1 vapaa, jne. (katso Tilestä)
Lukuoscripti skippaa välilyönnit. 20x16
1111 1111 1111 1111 1111
1000 0000 0000 0000 0001
1011 1100 0000 0011 1101
1011 1100 0000 0011 1101
1000 0000 0000 0000 0001
1000 0000 0000 0000 0001
1000 0000 0000 0000 0001
1000 0000 0000 0000 0001
1000 0000 0000 0000 0001
1000 0000 0000 0000 0001
1000 0000 0000 0000 0001
1000 0000 0000 0000 0001
1000 0000 0000 0000 0001
1000 0000 0000 0000 0001
1000 0000 0000 0000 0001
1111 1111 1111 1111 1111
Sitten 
EI OLE VIELÄ IMPLEMENTOITU!
E (viholliset, yksi rivi, yksi vihollinen)
XXYYHA.... mitä tarvitseekaan tietoja
XXYYHA....
I (itemit, yksi rivi kerrallaan)
XXYY.....
XXYY.....